W W W W W W W W W W W W W W W W W W W W W W W W W W
W C C C C C C C C C C C C C C C C C C C C C C C C W
W C W C C C C W W W W W C W W W W C W C C W C C C W
W C W C C C C W C C C C 1 W C C C C W C W C C C C W
W C W C C C C W C C C W C W C C C C W W C C C C C W
W C W C C C C W C C C W C W C C C C W C W C C C C W
W C W W W W C W W W W W C W W W W C W C C W C C C W
W C C C C C C C C C C C C C C C C C C C C C C C C W
W C C W W C W W C C C C C C W W C W W C C C 2 C C W
W C C W W C W W W C C C C C W W C W W C C C C C C W
W C C W W C W W W W C C C C W W C W W C C C C C C W
W C C W W C W W C W W C C C W W C W W C C C C C C W
W C C C C C W W C C W W C C W W C C C C C C C C C W
W C C C C C W W C C C W W C W W C C C C C C C C C W
W C C C C C W W C C C C W W W W C C C C C C C C C W
W C C C C C W W C C C C C W W W C C C C C C C C C W
W C C C C C W W C 3 C C C C W W C C C C C C C C C W
W C C L C C C C C C C C C C C C C C C C C C C C C W
W C W W W W C W C C W C W W W W C W W W C W W W C W
W C W C C C C W C C W C W C C W C W C C C W C C C W
W C W C C C C W W W W C W W W W C W W W C W W W C W
W C W C C C C W C C W C W C C W C C C W C W C C C W
W C W W W W C W C C W C W C C W C W W W C W W W C W
W C C C C C C C C C C C C C C C C C C C C C C C 0 W
W W W W W W W W W W W W W W W W W W W W W W W W W W
