W W W W W W W W W W W W W W W W W W W W W W W W W W
W C C C C C C C C C C C W W C C C C C C C C C C C W
W C W W W W C W W W W C W W C W W W W C W W W W C W
W C W W W W C W W W W C C C C W W W W C W W W W C W
W C W W W W C W W W W C W W C W W W W C W W W W C W
W C W W W W C W W W W C W W C W W W W C W W W W C W
W C C C C C C C C C C C W W C C C C C C C C C C C W
W C W W W W C W W C W W W W W W C W W C W W W W C W
W C W W W W C W W C W W W W W W C W W C W W W W C W
W C C C C C C W W C C C C C C C C W W C C C C C C W
W W W C W W C W W W W W T T W W W W W C W W C W W W
W W W C W C C C T T T T T T T T T T C C C W C W W W
W C C C W C W W T W T T T T T T W T W W C W C C C W
W C W W W C W W T W 0 T T T T 3 W T W W C W W W C W
W C C C C C W W T W T 1 T T 2 T W T W W C C C C C W
W C W W W C W W T W T T T T T T W T W W C W W W C W
W C C C W C W W T T T T T T T T T T W W C W C C C W
W W W C W C W W T W W W W W W W W T W W C W C W W W
W W W C W C C C C C C C C C C C C C C C C W C W W W
W C C C C C W W W W C W W W W W C W W W C C C C C W
W C W W W C W W W W C W W W W W C W W W C W W W C W
W C C C C C C C C C C C W W W C C C C C C C C C C W
W C W W W W C W W W W C W W W C W W W W C W W W C W
W C W W W W C W W W W C C C C C W W W W C W W W C W
W L C C C C C C C C C C W W W C C C C C C C C C C W
W W W W W W W W W W W W W W W W W W W W W W W W W W
